. . . . . . . . . . . . . . . . . . . . . . . . . . . . . . . . . . . . . . . . . . . . . . . . . . . . . . . . . . . . . . . .
. . . . . . . . . . . . . . . . . . . . . . . . . . . . . . . . . . . . . . . . . . . . . . . . . . . . . . . . . . . . . . . .
. . . . . . . . . . . . . . . . . . . . . . . . . . . . . . . . . . . . . . . . . . . . . . . . . . . . . . . . . . . . . . . .
. . . . . . . . . . . . . . . . . . . . . . . . . . . . . . . . . . . . . . . . . . . . . . . . . . . . . . . . . . V . . . . .
. . . . . . . . . . . . . . g . . . . . . . . . . . . . . . . . . . . . . . . . . . . . . . . . . . . . . g g g g g g g g . . .
. . . . . . . . . g g . . . G . . . . . . . . . . . . . . . . . . . . g g g . . . g g g g . . . . . . . . . . . . . . . . . . .
. . . . . . . . . . . . . . . . . . . . . . . . . . . . . . . . . g . . . . . . . . . . . . . . . . . g . . . . . . . . . . . .
. . F . . . g . . . . E . . . . E . . . . E . . . g . . T T . . . . . . . . . . . . . . . . . . . . . . . . . . . . . . . . . .
g g g g g g G g g g g g g g g g g g . . g g g g g G g g g g g g g . . . . . . . . . . . . . . . . g . . E . . . E . . . . . . .
G G G G G G G G G G G G G G G G G G G G G G G G G G G G G G G G G . . . . . . . . . . . . g g g g G g g g g g g g g g g g g g g