. . . . . . . . . . . . . . . . . . . . . . . . . . . . . . . . . . . . . . . . . . . . . . . . . . . . . . . . . . . . . . . .
. . . . . . . . . . . . . . . . . . . . . . . . . . . . . . . . . . . . . . . . . . . . . . . . . . . . . . . . . . . . . . . .
. . . . . . . . . . . . . . . . . . . . . . . . . . . . . . . . . . . . . . . . . . . . . . . . . . . . . . . . . . . . . . . .
. . . . . . . . . . . . . . . . . . . . . . . . . . . . . . . . . . . . . . . . . . . . . . . . . . . . . . . . . . . . . . . .
. . . . . . . . . . . . g . . . . . . . . . . . . . . . . . . . . . . . . . . . . . . . . . . . . . . . . . . . . . . . . . . .
. . . . . . . . . . . . . . . . . . . . . . . . . . . . . . . . . . . . . . . . . . . . . . . . . . . . . . . . . . . . . . . .
. . . . . . . . . . g . . . g . . . . . . . . . . . . . . . . . . . . . . . . . . . . . . . . g . . . g . . . g g g g g g g . .
g . F . . . . . . . . . . . . . . . . . . . T . . T . . . T T . . . . . . . . . . . . . . . . . . . . . . . . . . . . . . . . .
G g g g g g g g g . . E . . . . g g g g g g g g g g g g g g g g g . . . . E . . . . . . . g . . . . E . . . . . . . . . . V . .
G G G G G G G G G g g g g g g g G G G G G G G G G G G G G G G G G g g g g g g g g g g g g G g g g g g g g g g g g g g g g g g g