. . . . . . . . . . . . . . . . . . . . . . . . . . . . . . . . . . . . . . . . . . . . . . . . . . . . . . . . . . . . . . . .
. . . . . . . . . . . . . . . . . . . . . . . . . . . . . . . . . . . . . . . . . . . . . . . . . . . . . . . . . . . . . . . .
. . . . . . . . . . . . . . . . . . . . . . . . . . . . . . . . . . . . . . . . . . . . . . . . . . . . . . . . . . . . . . . .
. . . . . . . . . . . . . . . . . . . . . . . . . . . . . . . . . . . . . . . . . . . . . . . . . . . . . . . . . . . . . . . .
. . . . . . . . . . . . . . . . . . . . . . . . . . . . . . . . . . . . . . . . . . . . . . . . . . . . . . . . . . . . . . . .
. . . . . . . . . . . g . . . . . . . . . . . . . . . . . . . . . . . . . . . . . . . . . . . . . . . . . . . . . . . . V . . .
. . . . . . . . . . . . . . . g g g g g g g . . . . . . . . . . . . g g g g g . . . . . . . . . . . . . . . . g g g g g g g . .
. . . . F . . . . g g g . . . . . . . . . . . . . . . . . . . . . . . . . . . . . . . . . . . . . . . . g . . . . . . . . . . .
g g g g g g g g g G G G g g g g g g g g g g g g g g g g g g g g g . . . . E . . . . . g . . . . . . . . . . . . . . . . . . . .
G G G G G G G G G G G G G G G G G G G G G G G G G G G G G G G G G g g g g g g g g g g G g g g g g g g g g g g g g g g g g g g g